#########################################
#########################################
#########################################
###                                    ##
###                                    ##
###                                    ##
###                                    ##
###                                    ##
##                                     ##
##                                     ##
##                                     ##
##                                     ##
#                .                     ##
#               / \                    ##
#              /   \                   ##
#           ***|   |***                ##
#        ******  !  ******             ##
#                                      ##
#                                      ##
#                                      ##   --------         #
#########################################---  *     -----)####
#######################################(         #        )#### 
#####################################( #    **      *      )### 
######################################( *    *           **  )# #
##############################################################
